NO assets/North.jpg
SO assets/South.jpg
WE assets/West.jpg
EA assets/East.jpg
F assets/Floor.jpg
C assets/Ceiling.jpg



        1111111111111111111111111
        1000000000110000000000001
        1011000001110000000000001
        1001000000000000000000001
111111111011000001110000000000001
100000000011000001110111111111111
11110111111111011100000010001
11110111111111011101010010001
11000000110101011100000010001
10000000000000000000000010001
10000000000000001101010000001
11010111110101011111011110001
 1110111111101011101011010N01
   11111111111111111111111111
