NO Floor.jpg
SO Floor.jpg
WE Floor.jpg
EA Floor.jpg
F Floor.jpg
C Floor.jpg

111111111111111111111111111111111
1111000000000000000000000000001S1
111100000000000000000000000000111
111100000000000000000000000000001
111100000000000000000000000000001
111100000000000000000000000000001
111100000000000000000000000000001
111100000000000000000000000000001
111100000000000000000000000000001
111110000000000000000000000000001
111110000000000000000000000000001
111110000000000000000000000000001
111100000000000000000000000000001
111111111111111111111111111111111
