NO North.jpg
SO South.jpg
WE West.jpg
EA East.jpg
F Floor.jpg
C Ceiling.jpg

111111111111111111111111111111111
111111111000000000110000000000001
111111111011000001110000000000001
111111111001000000000000000000001
111111111011000001110000000000001
100000000011000001110111111111111
111101111111110111000000100011111
111101111111110111010100100011111
110000001101010111000000100011111
100000000000000000000000100011111
100000000000000011010100000011111
110101111101010111110111100011111
111101111111010111010110100S11111
111111111111111111111111111111111
